................
................
................
................
.........uvu....
................
................
....v...uvuvu...
................
..t..........t..
.1ggg2..b.1ggg2.
.t......t.....te
ggggggggcccggggg