................
................
................
................
................
.......ii.......
.......tt.......
.......tt.......
......1gg2......
................
...1gg2...12....
................
1gggggggggggggg2